{
  "width": 5,
  "height": 5,
  "index": [
    "w", "w", "w", "w", "w",
    "w", " ", " ", " ", "w",
    "w", " ", "b", " ", "w",
    "w", " ", " ", " ", "w",
    "w", "w", "w", "w", "w"
  ]
}

